R 1500 750
NO ./textures/square.png
SO ./textures/square_2.png
WE ./textures/square_3.png
EA ./textures/square_4.png
S ./textures/sprite_can_512.png
C ./textures/square.png
F ./textures/vloer.png

111111111111111111111111111111111111111111111111
122222222222222222222222222222222222222222222221
122222222222222222222222222222222222222222222221
122222222222222221111111111122222222222222222221
122222222222222222222222222222222222222222222221
122222222122222222222222222222222221222222222221
122222222122222222222222222222222221222222222221
122222222122222222222222222222222221222222222221
122222222122222222222222222222222221222222222221
12222222212222222222222N222222222221222222222221
122222222122222222222222222222222221222222222221
122222222122222222222222222222222221222222222221
122222222122222222222222222222222221222222222221
122222222122222222222222222222222221222222222221
122222222122222222222222222222222221222222222221
122222222122222222222222222222222221222222222221
122222222222222221111111111122222222222222222221
122222222222222222222222222222222222222222222221
122222222222222222222222222222222222222222222221
111111111111111111111111111111111111111111111111
